###############################################
###############################################
#############                 #################
############                   ################
###########                     ###############
##########                       ##############
#########      A           B      #############
########                           ############
#######                             ###########
######                               ##########
#####                                 #########
####                                   ########
###############################################
###############################################
###############################################
###############################################
###############################################