##############################################################
####      ###########################    ####          #######
#### ####                 #####       ####### ######## #######
#### #### ######### ##### ##### #####         ######## #######
#### #### ######### ##### ##### ################## ### #######
#### #### ### #####   ### #####       ########     ###    ####
##   #### ### ## ########       ##### ######## ### ###### ####
## ###### #        ###### ########### ######## ###        ####
## ###### ### ####       B                #### ###### ### ####
## ######      ############ ######## #### #### ###    ### ####
## ########################          ####      ### ###### ####
##                   ###### ## ### ###### ####     ###### ####
######### ################# ## ### ###### ############### ####
######### ###########       ######   ####             ### ####
###              #### ################### ### ####### ### ####
###### ## ########### ###             ### ### ##      ###   ##
##  ## ## ########### ### ########################### ##### ##
## ### ##                 ############            ### ##### ##
##    A   ###############       ###### ############## ##### ##
###### ##### ### ### #### ##### ######       ########       ##
##                        #####        #####          ########
##############################################################